wwwwwwwwwwwwwwwwwwwwwwwwwwwwwwwww
w000000000000000000000w000000000w
w000000000000000000000w000000000w
w00www0www000000000000w000000000w
w00w000www000000000000w00wwwwwwww
w00w00000000000wwwww00w00w000000w
w00w000000000www000000w00w000000w
w00w000000000w00000000w00w000000w
w00wwwwwwwwwww00000000w00w000000w
w00w0000000w00000000www00w000000w
w00w0000000w0000000000w00ww2w000w
w00w0000000w00000ww000w000000000w
w00w0000000w0000000000w000000000w
w00w0000000wwww0000000w0000000www
w00w000000000000000000w000000000w
w00w000000000000000000w000ww0000w
w00wdd0dd0000000000000ww1www0000w
w00wdd0dd0000000000000000000000ww
w00wwwwwww000000000000000000000ww
w000000www00000000wwww000000000ww
w000000www00www00000000000000wwww
w000000wwwGGGGGGGGGGGGGGGGwwwwwww
wwwwwwwwwwGGGGGGGGGGGGGGGGwwwwwww
wwwwwwwwwwwwwwwwwwwwwwwwwwwwwwwww